{
    "my_room": {
        "map": [
            "........................................",
            "........................................",
            "########################################",
            "#......................................#",
            "#......................................#",
            "#......................................#",
            "#......................................#",
            "#......................................#",
            "#......................................#",
            "#......................................#",
            "#......................................#",
            "D......................................D",
            "#......................................#",
            "#......................................#",
            "#......................................#",
            "#......................................#",
            "#......................................#",
            "#......................................#",
            "#......................................#",
            "########################################"
        ],
        "exits": {
            "west": [
                0,
                11
            ],
            "east": [
                39,
                11
            ]
        }
    }
}