{
    "my_room": {
        "map": [
            "........................................",
            "........................................",
            "........................................",
            "........................................",
            "..........######################........",
            "..........#................#####........",
            "..........#................#####........",
            "..........#.................####........",
            "..........#.................####........",
            "..........#..................###........",
            "..........#..................###........",
            "..........#...................##........",
            "..........#...................##........",
            "..........#....................#........",
            "..........#..................##.........",
            "..........###..............##...........",
            ".............####........##.............",
            ".................###....#...............",
            "........................................",
            "........................................"
        ],
        "exits": {}
    }
}